To run the Ray Tracer just type make. This is an interactive type Ray tracer
so below are the available keyboard buttons you can use while it is running:

? Camera Movement:
o w - move forward;
o s - move backward;
o a - move left;
o d - move right;
o q - move up;
o e - move down;

? Camera Rotation (arrow keys):
o down - rotate down;
o up - rotate up;
o left - rotate left;
o right - rotate right;

? Reset Camera position and rotation:
o r - reset position;

? Light Source Movement:
o i - move light source in;
o k - move light source out;
o j - move light source left;
o l - move light source right;
o u - move light source up;
o o - move light source down;

? Photon Mapping:
o z - turn on photon mapping;
o x - turn off photon mapping;

? Depth of Field:
o c - turn on Depth of Field;
o v - turn off Depth of Field;
o b - decrease focal distance;
o n - increase focal distance;

